20
X X X X X X X X X X
X O O O O X O O O X
X O O O O O O O O X
X O O O O O O O X X
X X O O O O O O O X
X O O X O O O O O X
X O O G O O O O O X
X X O O X O O O O X
X O O O O O O O X X
X O O O O O O O O X
X O O O O X O O O X
X O X O O O O O O X
X X O O X O O O O X
X O O O O O O O O X
X O O O S X O O O X
X O O O O O O O O X
X O O O O O O O O X
X X X X X X X X X X
