31
X X X X X X X X X X
X O X O O O X O O X
X O O O X O O G O X
X X O O O O O X X X
X O O O O O O O O X
X O X O O S X O O X
X O O X O O O O O X
X X O O O O O O O X
X O O O X O O O O X
X X X O O X O O O X
X O O O O O O O O X
X O O X O O O O O X
X X O O O O O O O X
X O O O O X O O O X
X O O O O O O X O X
X O O O O O O O X X
X O O O X O O O O X
X X X X X X X X X X
