2
X X X X X X X X X X
X O O O O O O O G X
X O O O O O O O O X
X O O O O O O O O X
X O O O O O O O O X
X O O O O O O O O X
X O O O O O O O O X
X O O O O O O O O X
X O O O O O O O O X
X O O O O O O O O X
X O O O O O O O O X
X O O O O O O O O X
X O O O O O O O O X
X O O O O O O O O X
X O O O O O O O O X
X O O O O O O O O X
X O O O S O O O O X
X X X X X X X X X X
